10
9
▩▩▩▩▩ㅤㅤㅤㅤㅤ
▩★ㅤㅤ▩ㅤㅤㅤㅤㅤ
▩ㅤ●●▩ㅤ▩▩▩▩
▩ㅤ●ㅤ▩▩▩ㅤ◆▩
▩▩▩ㅤㅤㅤㅤㅤ◆▩
ㅤ▩▩ㅤㅤ▩ㅤㅤ◆▩
ㅤ▩ㅤㅤㅤ▩ㅤㅤㅤ▩
ㅤ▩ㅤㅤㅤ▩▩▩▩▩
ㅤ▩▩▩▩▩ㅤㅤㅤㅤ