8
8
ㅤㅤ▩▩▩ㅤㅤㅤ
ㅤㅤ▩◆▩ㅤㅤㅤ
ㅤㅤ▩●▩▩▩▩
▩▩▩ㅤㅤ●◆▩
▩◆●ㅤ★▩▩▩
▩▩▩▩●▩ㅤㅤ
ㅤㅤㅤ▩◆▩ㅤㅤ
ㅤㅤㅤ▩▩▩ㅤㅤ